XXXXXXXXXXXXX  XXXXXXXXXXXXX
XggggggggXXXX  XXXXggggggggX
XgXgXXXXgXXXX  XXXXgXXXXgXgX
XgXgXXXXgXXXX  XXXXgXXXXgXgX
XgXgXXXXggggggggggggXXXXgXgX
XgXSgggggXXXXXXXXXXgggggSXgX
XgXXXXXXgXXXXXXXXXXgXXXXXXgX
Xgggggggg     1    ggggggggX
XgXXgXXX   XXDDXX   XXXgXXgX
XgXXgXXX   X    X   XXXgXXgX
XggggXXX   X 234X   XXXggggX
XgXXggggg  XXXXXX  gggggXXgX
XgXXXXgXXX        XXXgXXXXgX
XgXXXXgXXX        XXXgXXXXgX
XgggggggXX        XXgggggggX
XXgXXXXgXXXXXggXXXXXgXXXXgXX
XXgXXXXgXXXXXggXXXXXgXXXXgXX
XXgXXXXggggXXggXXggggXXXXgXX
XXgXXXXggggXXggXXggggXXXXgXX
Xgggggggggggg PggggggggggggX
XgXXXXXgXXXXggggXXXXgXXXXXgX
XgXXXXXgXXXXggggXXXXgXXXXXgX
XggggSXgXXXXggggXXXXgXSggggX
XgXXXgXgXXXXgXXgXXXXgXgXXXgX
XgXXXggggggggXXggggggggXXXgX
XgXXXgXXgXXXXXXXXXXgXXgXXXgX
XgXXXgXXgXXXXXXXXXXgXXgXXXgX
XgggggXXggggggggggggXXgggggX
XgXXXXXXgXXXX  XXXXgXXXXXXgX
XgXXXXXXgXXXX  XXXXgXXXXXXgX
XggggggggXXXX  XXXXggggggggX
XXXXXXXXXXXXX  XXXXXXXXXXXXX     