XXXXXXXXXXWWX  XWWXXXXXXXXXX
XggggggggXWWX  XWWXggggggggX
XgXgXXXXgXWWX  XWWXgXXXXgXgX
XgXgXXXXgXXXX  XXXXgXXXXgXgX
XgXgXXXXggggggggggggXXXXgXgX
XgXSgggggXXXXXXXXXXgggggSXgX
XgXXXXXXgXXXXXXXXXXgXXXXXXgX
Xggggggg      1     gggggggX
XgXXgXXX   XXDDXX   XXXgXXgX
XgXXgXXX   X    X   XXXgXXgX
XgXXgXXX   X 234X   XXXgXXgX
XgXXgggg   XXXXXX   ggggXXgX
XgXXXXgXXX        XXXgXXXXgX
XgXXXXgXXX        XXXgXXXXgX
XgggggggXX    F   XXgggggggX
XXgXXXXgXXXXXggXXXXXgXXXXgXX
WXgXXXXgXXXXXggXXXXXgXXXXgXW
WXgXXXXgXXXXXggXXXXXgXXXXgXW
XXgXXXXgXXXXggggXXXXgXXXXgXX
XggXXXXgXXXXg PgXXXXgXXXXggX
XgXXXXXgXXXXgXXgXXXXgXXXXXgX
XgXXXXXgXXXXgXXgXXXXgXXXXXgX
XggggSXgXXXXgXXgXXXXgXSggggX
XgXXXgXgXXXXgXXgXXXXgXgXXXgX
XgXXXggggggggXXggggggggXXXgX
XgXXXgXXgXXXXXXXXXXgXXgXXXgX
XgXXXgXXgXXXXXXXXXXgXXgXXXgX
XgggggXXggggggggggggXXgggggX
XgXXXXXXgXXXX  XXXXgXXXXXXgX
XgXXXXXXgXWWX  XWWXgXXXXXXgX
XggggggggXWWX  XWWXggggggggX
XXXXXXXXXXWWX  XWWXXXXXXXXXX     