XXXXXXXXXXXXXXXXXXXXXXXXX
XgggggggggggXgggggggggggX
XSXXXXgXXXXgXgXXXXgXXXXSX
XgggggggggggggggggggggggX
XgXXXgXgXXXXXXXXXgXgXXXgX
XgggggXgggggXgggggXgggggX
XXXXXgXXXXX X XXXXXgXXXXX
WWWWXgX     1     XgXWWWW
XXXXXgX  XXDDXX   XgXXXXX
     g   X 234X    g     
XXXXXgX  XXXXXX   XgXXXXX
WWWWXgX     F     XgXWWWW
XXXXXgX XXXXXXXXX XgXXXXX
XgggggggggggXgggggggggggX
XgXXXXgXXXXgXgXXXXgXXXXgX
XSgggXggggggPggggggXgggSX
XXXXgggXXXXXXXXXXXgggXXXX
XggggXggggggXggggggXggggX
XgXXXXXXXXXgXgXXXXXXXXXgX
XgggggggggggggggggggggggX
XXXXXXXXXXXXXXXXXXXXXXXXX