XXXXXXXXXXXXXXXXXXXXXXXXXXXX
XggggggggggggXXggggggggggggX
XgXXXXgXXXXXgXXgXXXXXgXXXXgX
XSXXXXgXXXXXgXXgXXXXXgXXXXSX
XgXXgggggggggXXgggggggggXXgX
XgXXgXXXXXXXgXXgXXXXXXXgXXgX
XggggggggggggggggggggggggggX
XgXXXXgXXgXXXXXXXXgXXgXXXXgX
XgXXXXgXXgXXXXXXXXgXXgXXXXgX
XggggggXXggggXXggggXXggggggX
XXXXXXgXXXXX XX XXXXXgXXXXXX
WWWWWXgXX          XXgXWWWWW
WWWWWXgXX          XXgXWWWWW
WWWWWXgXX     1    XXgXWWWWW
XXXXXXgXX  XXDDXX  XXgXXXXXX
      g    X 234X    g      
XXXXXXgXX  XXXXXX  XXgXXXXXX
WWWWWXgXX          XXgXWWWWW
WWWWWXgXX          XXgXWWWWW
WWWWWXgXX     F    XXgXWWWWW
XXXXXXgXX XXXXXXXX XXgXXXXXX
XggggggggggggXXggggggggggggX
XgXXXXgXXXXXgXXgXXXXXgXXXXgX
XgXXXXgXXXXXgXXgXXXXXgXXXXgX
XSggXXgXXgggg PggggXXgXXggSX
XXXgXXggggXXXXXXXXgXXggggXXX
XXXgXXgXXgXXXXXXXXgXXgXXgXXX
XgggXXgggggggXXgggggggXXgggX
XgXXXXXXXXXXgXXgXXXXXXXXXXgX
XgXXXXXXXXXXgXXgXXXXXXXXXXgX
XggggggggggggggggggggggggggX
XXXXXXXXXXXXXXXXXXXXXXXXXXXX