XXXXXXXXXXWWWWWXXXXXXXXXX
XgggggggSXWWWWWXSgggggggX
XgXgXXXXgXXXXXXXgXXXXgXgX
XgXgggggggggggggggggggXgX
XgXXXXXXggg   gggXXXXXXgX
Xggggggg    1    gggggggX
XgXXgXXX  XXXXX  XXXgXXgX
XgXXgXXX  X234X  XXXgXXgX
XgXXgggg  XXDXX  ggggXXgX
XgXXXXgXX       XXgXXXXgX
XgggggggXX  P  XXgggggggX
XXXXXXXgXXXX XXXXgXXXXXXX
XXXXXXXgXXXg gXXXgXXXXXXX
XgSXXXXgXXXgFgXXXgXXXXSgX
XgggggXgXXX   XXXgXgggggX
XgXXXgXgXXXgXgXXXgXgXXXgX
XgXXXgggggggXgggggggXXXgX
XgggggXgXXXXXXXXXgXgggggX
XgXXXgXgggggggggggXgXXXgX
XgggggggXXXXXXXXXgggggggX
XXXXXXXXXWWWWWWWWXXXXXXXX