XXXXXXXXXXXXXXXXXXXXXXXXX
XgggggggggggggggggggggggX
XgXXgXXXXXXXXXXXXXXXgXXgX
XSgXgggggggggggggggggXgSX
XXgXX1              XXgXX
WXgXXDXX   ggg    XXXXgXW
XXgX234X   gFg    XXXXgXX
XggXXXXX   ggg    XXXXggX
XgXXXX             XXXXgX
XggggggXXXXX XXXXXggggggX
XgXXXXgXXXXX XXXXXgXXXXgX
XgXXXXgggggg ggggggXXXXgX
XgggSXgXXXXXPXXXXXgXSgggX
XgXXgXgXXXgg ggXXXgXgXXgX
XgXXgXgXXggX XggXXgXgXXgX
XgXXgXgXggXX XXggXgXgXXgX
XggggXgggXXgggXXgggXggggX
XgXXgXXgXXXXgXXXXgXXgXXgX
XgXXgXXgXXXXgXXXXgXXgXXgX
XgggggggggggggggggggggggX
XXXXXXXXXXXXXXXXXXXXXXXXX