XXXXXXXXXXWWWWWWWWXXXXXXXXXX
XgggggggSXWWWWWWWWXSgggggggX
XgXgXXXXgXXXXXXXXXXgXXXXgXgX
XgXgXXXXgXXX    XXXgXXXXgXgX
XgXgXXXXgggggXXgggggXXXXgXgX
XgXggggggggggXXggggggggggXgX
XgXXXXXXggg  XX  gggXXXXXXgX
Xggggggg      1     gggggggX
XgXXgXXX   XXXXXX   XXXgXXgX
XgXXgXXX   X    X   XXXgXXgX
XgXXgXXX   X 234X   XXXgXXgX
XgXXgggg   XXDDXX   ggggXXgX
XgXXXXgXXX        XXXgXXXXgX
XgXXXXgXXX        XXXgXXXXgX
XgggggggXX    P   XXgggggggX
XXXXXXXg  X XggX X  gXXXXXXX
WWWWWWXgX X XggX X XgXWWWWWW
WWWWWWXgX   XggX   XgXWWWWWW
XXXXXXXgXXXXggggXXXXgXXXXXXX
XgSXXXXgXXXXg FgXXXXgXXXXSgX
Xg XXXXgXXXXgXXgXXXXgXXXX gX
XgXXXXXgXXXXgXXgXXXXgXXXXXgX
XgggggXgXXXXgXXgXXXXgXgggggX
XgXXXgXgXXXXgXXgXXXXgXgXXXgX
XgXXXggggggggXXggggggggXXXgX
XgXXXgXXgXXXXXXXXXXgXXgXXXgX
XgXXXgXXgXXXXXXXXXXgXXgXXXgX
XgggggXXgggggXXgggggXXgggggX
XgXXXXXXgXXX    XXXgXXXXXXgX
XgXXXXXXgXXXXXXXXXXgXXXXXXgX
XggggggggXWWWWWWWWXggggggggX
XXXXXXXXXXWWWWWWWWXXXXXXXXXX     