XXXXXXXXXXXXX  XXXXXXXXXXXXX
X        XXXX  XXXX        X
X X XXXX XXXX  XXXX XXXX X X
X X XXXX XXXX  XXXX XXXX X X
X X XXXX            XXXX X X
X XS     XXXXXXXXXX     SX X
X XXXXXX XXXXXXXXXX XXXXXX X
X             1            X
X XX XXX   XXDDXX   XXX XX X
X XX XXX   X    X   XXX XX X
X    XXX   X 234X   XXX    X
X XX       XXXXXX       XX X
X XXXX XXX        XXX XXXX X
X XXXX XXX        XXX XXXX X
X       XX        XX       X
XX XXXX XXXXX  XXXXX XXXX XX
XX XXXX XXXXX  XXXXX XXXX XX
XX XXXX    XX  XX    XXXX XX
XX XXXX    XX  XX    XXXX XX
X             P            X
X XXXXX XXXX    XXXX XXXXX X
X XXXXX XXXX    XXXX XXXXX X
X    SX XXXX    XXXX XS    X
X XXX X XXXX XX XXXX X XXX X
X XXX        XX        XXX X
X XXX XX XXXXXXXXXX XX XXX X
X XXX XX XXXXXXXXXX XX XXX X
X     XX            XX     X
X XXXXXX XXXX  XXXX XXXXXX X
X XXXXXX XXXX  XXXX XXXXXX X
X        XXXX  XXXX        X
XXXXXXXXXXXXX  XXXX XXXXXXXX     